//MAP CONVERTED BY dmm2tgm.py THIS HEADER COMMENT PREVENTS RECONVERSION, DO NOT REMOVE
"aa" = (
/turf/template_noop,
/area/template_noop)
"ab" = (
/turf/closed/wall/mineral/titanium/nodiagonal,
/area/ruin/powered/golem_ship)
"ac" = (
/obj/structure/closet/crate,
/obj/item/shovel,
/obj/item/shovel,
/obj/item/shovel,
/obj/item/pickaxe,
/obj/item/pickaxe,
/obj/item/pickaxe,
/obj/item/storage/bag/ore,
/obj/item/storage/bag/ore,
/obj/item/mining_scanner,
/obj/item/flashlight/lantern,
/obj/item/card/id/mining,
/turf/open/floor/plating,
/area/ruin/powered/golem_ship)
"ad" = (
/obj/structure/closet/crate,
/obj/item/shovel,
/obj/item/shovel,
/obj/item/pickaxe,
/obj/item/pickaxe,
/obj/item/storage/bag/ore,
/obj/item/storage/bag/ore,
/obj/item/mining_scanner,
/obj/item/flashlight/lantern,
/obj/item/card/id/mining,
/turf/open/floor/plating,
/area/ruin/powered/golem_ship)
"ae" = (
/obj/item/storage/toolbox/mechanical,
/turf/open/floor/plating,
/area/ruin/powered/golem_ship)
"af" = (
/turf/open/floor/plating,
/area/ruin/powered/golem_ship)
"ag" = (
/obj/structure/reagent_dispensers/watertank,
/turf/open/floor/plating,
/area/ruin/powered/golem_ship)
"ah" = (
/obj/structure/shuttle/engine/heater{
	dir = 4
	},
/obj/structure/window/reinforced{
	dir = 8
	},
/turf/open/floor/plating,
/area/ruin/powered/golem_ship)
"ai" = (
/obj/structure/shuttle/engine/propulsion{
	dir = 4
	},
/turf/open/floor/plating,
/area/ruin/powered/golem_ship)
"aj" = (
/obj/machinery/door/airlock/titanium,
/turf/open/floor/mineral/titanium/purple,
/area/ruin/powered/golem_ship)
"ak" = (
/obj/machinery/computer/arcade/battle,
/turf/open/floor/mineral/titanium/purple,
/area/ruin/powered/golem_ship)
"al" = (
/turf/open/floor/mineral/titanium/purple,
/area/ruin/powered/golem_ship)
"am" = (
/obj/effect/mob_spawn/human/golem/adamantine,
/turf/open/floor/mineral/titanium/purple,
/area/ruin/powered/golem_ship)
"an" = (
/obj/machinery/mineral/equipment_vendor/golem,
/turf/open/floor/mineral/titanium/purple,
/area/ruin/powered/golem_ship)
"ao" = (
/obj/item/resonator,
/turf/open/floor/mineral/titanium/purple,
/area/ruin/powered/golem_ship)
"ap" = (
/obj/machinery/mineral/ore_redemption,
/turf/open/floor/mineral/titanium/purple,
/area/ruin/powered/golem_ship)
"aq" = (
/obj/structure/statue/gold/rd,
/obj/structure/window/reinforced{
	dir = 4;
	name = "shrine of the liberator"
	},
/obj/machinery/light{
	dir = 8
	},
/turf/open/floor/mineral/titanium/purple,
/area/ruin/powered/golem_ship)
"ar" = (
/obj/machinery/computer/shuttle,
/turf/open/floor/mineral/titanium/purple,
/area/ruin/powered/golem_ship)
"as" = (
/obj/machinery/light/directional/west,
/turf/open/floor/mineral/titanium/purple,
/area/ruin/powered/golem_ship)
"at" = (
/obj/structure/extinguisher_cabinet{
	pixel_y = 30
	},
/turf/open/floor/mineral/titanium/purple,
/area/ruin/powered/golem_ship)
"au" = (
/obj/structure/table/wood,
/obj/item/bedsheet/rd/royal_cape{
	layer = 3;
	pixel_x = 5;
	pixel_y = 9
	},
/obj/item/book/manual/wiki/research_and_development{
	name = "Sacred Text of the Liberator";
	pixel_x = -4;
	pixel_y = 3
	},
/obj/structure/window/reinforced{
	dir = 4;
	name = "shrine of the liberator"
	},
/turf/open/floor/mineral/titanium/purple,
/area/ruin/powered/golem_ship)
"av" = (
/obj/item/resonator/upgraded,
/turf/open/floor/mineral/titanium/purple,
/area/ruin/powered/golem_ship)
"aw" = (
/obj/machinery/autolathe,
/turf/open/floor/mineral/titanium/purple,
/area/ruin/powered/golem_ship)
"ax" = (
/obj/structure/table/wood,
/obj/machinery/reagentgrinder,
/turf/open/floor/mineral/titanium/purple,
/area/ruin/powered/golem_ship)
"ay" = (
/obj/machinery/computer/arcade/orion_trail,
/turf/open/floor/mineral/titanium/purple,
/area/ruin/powered/golem_ship)
"az" = (
/obj/structure/extinguisher_cabinet{
	pixel_y = -30
	},
/turf/open/floor/mineral/titanium/purple,
/area/ruin/powered/golem_ship)
"aA" = (
/obj/structure/table/wood,
/obj/item/surgical_drapes{
	pixel_x = 15
	},
/obj/item/storage/firstaid/fire,
/obj/item/storage/firstaid/fire,
/turf/open/floor/mineral/titanium/purple,
/area/ruin/powered/golem_ship)
"aB" = (
/obj/item/storage/firstaid/fire,
/obj/structure/table/wood,
/obj/item/storage/firstaid/fire,
/obj/machinery/light,
/turf/open/floor/mineral/titanium/purple,
/area/ruin/powered/golem_ship)
"aC" = (
/obj/item/storage/firstaid/brute,
/obj/structure/table/wood,
/obj/item/storage/firstaid/brute,
/obj/item/areaeditor/blueprints{
	desc = "Use to build new structures in the wastes.";
	name = "land claim"
	},
/turf/open/floor/mineral/titanium/purple,
/area/ruin/powered/golem_ship)
"aD" = (
/obj/item/storage/firstaid/brute,
/obj/structure/table/wood,
/obj/item/storage/firstaid/brute,
/obj/item/disk/design_disk/golem_shell,
/turf/open/floor/mineral/titanium/purple,
/area/ruin/powered/golem_ship)
"aE" = (
/obj/structure/reagent_dispensers/fueltank,
/turf/open/floor/plating,
/area/ruin/powered/golem_ship)
"aF" = (
/obj/structure/ore_box,
/turf/open/floor/plating,
/area/ruin/powered/golem_ship)
"aG" = (
/turf/closed/wall/mineral/titanium,
/area/ruin/powered/golem_ship)
"aH" = (
/obj/machinery/door/airlock/titanium,
/obj/structure/fans/tiny,
/turf/open/floor/mineral/titanium/purple,
/area/ruin/powered/golem_ship)
"aI" = (
/obj/machinery/light/small,
/turf/open/floor/plating,
/area/ruin/powered/golem_ship)
"aJ" = (
/obj/structure/extinguisher_cabinet/directional/south,
/turf/open/floor/mineral/titanium/purple,
/area/ruin/powered/golem_ship)
"aK" = (
/obj/machinery/door/airlock/titanium,
/obj/structure/fans/tiny,
/obj/effect/mapping_helpers/airlock/cyclelink_helper{
	dir = 8
	},
/turf/open/floor/mineral/titanium/purple,
/area/ruin/powered/golem_ship)
"aL" = (
/obj/machinery/light/small{
	dir = 1
	},
/turf/open/floor/mineral/titanium/purple,
/area/ruin/powered/golem_ship)
"aM" = (
/obj/effect/mob_spawn/human/golem/adamantine,
/obj/machinery/light/small{
	dir = 1
	},
/turf/open/floor/mineral/titanium/purple,
/area/ruin/powered/golem_ship)
"aN" = (
/obj/machinery/light{
	dir = 1
	},
/turf/open/floor/mineral/titanium/purple,
/area/ruin/powered/golem_ship)
"aO" = (
/obj/machinery/light{
	dir = 8
	},
/turf/open/floor/mineral/titanium/purple,
/area/ruin/powered/golem_ship)
"aP" = (
/obj/item/storage/firstaid/fire,
/obj/structure/table/wood,
/obj/item/storage/firstaid/fire,
/obj/machinery/light/directional/south,
/turf/open/floor/mineral/titanium/purple,
/area/ruin/powered/golem_ship)
"aQ" = (
/obj/machinery/light/small,
/turf/open/floor/mineral/titanium/purple,
/area/ruin/powered/golem_ship)
"aR" = (
/obj/machinery/light/small/directional/north,
/turf/open/floor/mineral/titanium/purple,
/area/ruin/powered/golem_ship)
"aS" = (
/obj/effect/mob_spawn/human/golem/adamantine,
/obj/machinery/light/small/directional/south,
/turf/open/floor/mineral/titanium/purple,
/area/ruin/powered/golem_ship)
"aT" = (
/obj/structure/fans/tiny,
/obj/machinery/door/airlock/titanium,
/turf/open/floor/mineral/titanium/purple,
/area/ruin/powered/golem_ship)
"aU" = (
/obj/effect/mob_spawn/human/golem/adamantine,
/obj/machinery/light/small,
/turf/open/floor/mineral/titanium/purple,
/area/ruin/powered/golem_ship)
"aV" = (
/obj/machinery/light/small{
	dir = 1
	},
/turf/open/floor/plating,
/area/ruin/powered/golem_ship)
"aW" = (
/obj/machinery/light/small/directional/south,
/turf/open/floor/mineral/titanium/purple,
/area/ruin/powered/golem_ship)
"aX" = (
/obj/structure/statue/gold/rd,
/obj/structure/window/reinforced{
	dir = 4;
	name = "shrine of the liberator"
	},
/obj/machinery/light/directional/west,
/turf/open/floor/mineral/titanium/purple,
/area/ruin/powered/golem_ship)
"aY" = (
/obj/machinery/door/airlock/titanium,
/obj/effect/mapping_helpers/airlock/cyclelink_helper{
	dir = 4
	},
/turf/open/floor/mineral/titanium/purple,
/area/ruin/powered/golem_ship)
"aZ" = (
/obj/machinery/light/small/directional/north,
/turf/open/floor/plating,
/area/ruin/powered/golem_ship)
"bj" = (
/obj/effect/mob_spawn/human/golem/adamantine,
/obj/machinery/light/small/directional/north,
/turf/open/floor/mineral/titanium/purple,
/area/ruin/powered/golem_ship)
"ie" = (
/obj/structure/extinguisher_cabinet/directional/north,
/turf/open/floor/mineral/titanium/purple,
/area/ruin/powered/golem_ship)
"Ad" = (
/obj/machinery/light/small/directional/south,
/turf/open/floor/plating,
/area/ruin/powered/golem_ship)
"Ij" = (
/obj/structure/closet/crate,
/obj/item/shovel,
/obj/item/shovel,
/obj/item/pickaxe,
/obj/item/pickaxe,
/obj/item/storage/bag/ore,
/obj/item/storage/bag/ore,
/obj/item/mining_scanner,
/obj/item/flashlight/lantern,
/obj/item/card/id/advanced/mining,
/turf/open/floor/plating,
/area/ruin/powered/golem_ship)
"JR" = (
/obj/structure/closet/crate,
/obj/item/shovel,
/obj/item/shovel,
/obj/item/shovel,
/obj/item/pickaxe,
/obj/item/pickaxe,
/obj/item/pickaxe,
/obj/item/storage/bag/ore,
/obj/item/storage/bag/ore,
/obj/item/mining_scanner,
/obj/item/flashlight/lantern,
/obj/item/card/id/advanced/mining,
/turf/open/floor/plating,
/area/ruin/powered/golem_ship)
"VS" = (
/obj/machinery/light/directional/north,
/turf/open/floor/mineral/titanium/purple,
/area/ruin/powered/golem_ship)

(1,1,1) = {"
aa
aa
aa
aa
aa
aa
ab
ab
ab
ab
aa
aa
aa
aa
aa
aa
"}
(2,1,1) = {"
aa
aa
aa
aa
aa
aa
ab
aX
au
aG
aa
aa
aa
aa
aa
aa
"}
(3,1,1) = {"
aa
aa
aa
ab
ab
aH
ab
ar
al
aG
aT
ab
ab
aa
aa
aa
"}
(4,1,1) = {"
aa
aa
aa
ab
ak
al
aj
al
al
aj
al
ay
ab
aa
aa
aa
"}
(5,1,1) = {"
aa
aa
aa
ab
aR
al
aj
al
al
aj
al
al
ab
aa
aa
aa
"}
(6,1,1) = {"
ab
ab
ab
ab
al
al
ab
al
aW
aG
al
aW
ab
ab
ab
ab
"}
(7,1,1) = {"
ab
JR
af
aj
al
al
ab
al
al
aG
al
al
aj
af
aF
ab
"}
(8,1,1) = {"
ab
JR
af
aj
al
al
ab
aR
al
aG
al
al
aj
af
aF
ab
"}
(9,1,1) = {"
ab
JR
Ad
ab
bj
ao
ab
al
al
aG
ao
aS
ab
aZ
aF
ab
"}
(10,1,1) = {"
ab
JR
af
ab
am
ao
ab
al
al
aG
ao
am
ab
af
aF
ab
"}
(11,1,1) = {"
ab
JR
af
ab
ab
aj
ab
aj
aj
aG
aj
ab
ab
af
aF
ab
"}
(12,1,1) = {"
ab
JR
Ad
ab
al
al
as
al
al
as
al
aJ
ab
aZ
aF
ab
"}
(13,1,1) = {"
ab
Ij
af
aj
al
al
al
al
al
al
al
al
aj
af
aF
ab
"}
(14,1,1) = {"
ab
Ij
af
aj
al
al
al
al
al
al
al
al
aj
af
ae
ab
"}
(15,1,1) = {"
ab
Ij
af
ab
al
al
al
al
al
al
al
aA
ab
af
af
ab
"}
(16,1,1) = {"
aT
ae
Ad
ab
VS
al
al
al
al
av
al
aP
ab
aZ
af
aT
"}
(17,1,1) = {"
aT
af
af
ab
al
al
ap
al
al
aw
al
aC
ab
af
af
aT
"}
(18,1,1) = {"
ab
ag
ag
ab
an
al
ab
aY
aY
ab
ax
aD
ab
aE
aE
ab
"}
(19,1,1) = {"
ab
ah
ah
ab
ah
ah
ab
ie
aW
ab
ah
ah
ab
ah
ah
ab
"}
(20,1,1) = {"
ab
ai
ai
ab
ai
ai
ab
aK
aK
ab
ai
ai
ab
ai
ai
ab
"}
